# # # # # # # # # # # # # #
# P 0 0 0 S S S S 0 0 0 # #
# 0 B 0 T T T T T T B 0 # #
# 0 B 0 T B W W B T 0 0 # #
# S 0 0 T B W W B T 0 S # #
# S 0 0 T B W W B T 0 S # #
# S S 0 T B W W B T S S # #
# S 0 0 T B W W B T 0 S # #
# S 0 0 T B W W T T 0 S # #
# 0 0 0 T B W W T T 0 0 # #
# 0 B 0 T B W W T T 0 0 # #
# 0 B 0 T B T T T T B 0 # #
# 0 0 0 0 S S S S 0 0 0 # #
# # # # # # # # # # # # # #